5,3,4,3,4,3,4,3,4,3,4,3,4,3,4,3,6
3,0,0,0,0,0,0,0,0,0,0,0,0,0,0,0,3
3,0,0,0,0,0,0,0,0,0,0,0,0,0,0,0,4
3,0,0,0,4,4,4,0,0,0,4,4,5,0,0,0,4
3,0,0,0,3,0,0,0,0,0,0,0,3,0,0,0,3
3,0,0,0,0,0,0,0,0,0,0,0,0,0,0,0,3
3,0,0,0,0,0,0,0,0,0,0,0,0,0,0,0,3
3,0,0,0,0,0,0,0,0,0,0,0,0,0,0,0,3
3,0,0,0,3,0,0,0,0,0,0,0,3,0,0,0,3
3,0,0,0,4,4,4,0,0,0,4,4,6,0,0,0,3
3,0,0,0,0,0,0,0,0,0,0,0,0,0,0,0,3
3,0,0,0,0,0,0,0,0,0,0,0,0,0,0,0,3
3,3,3,3,3,3,3,3,3,3,3,3,3,3,3,3,3
