1,2,3,2,3,2,3,2,3,2,3,2,3,2,3,2,1
4,0,0,0,0,0,0,0,0,0,0,0,0,0,0,0,4
5,0,0,0,0,0,0,0,0,0,0,0,0,0,0,0,5
4,0,0,0,1,1,0,0,0,0,0,1,1,0,0,0,4
5,0,0,0,1,0,0,0,0,0,0,0,1,0,0,0,5
4,0,0,0,0,0,0,0,0,0,0,0,0,0,0,0,4
5,0,0,0,0,0,0,0,0,0,0,0,0,0,0,0,5
4,0,0,0,0,0,0,0,0,0,0,0,0,0,0,0,4
5,0,0,0,1,0,0,0,0,0,0,0,1,0,0,0,5
4,0,0,0,1,1,0,0,0,0,0,1,1,0,0,0,4
5,0,0,0,0,0,0,0,0,0,0,0,0,0,0,0,5
4,0,0,0,0,0,0,0,0,0,0,0,0,0,0,0,4
1,1,1,1,1,1,1,1,1,1,1,1,1,1,1,1,1
