000000000000000
000000000000000
001100000001100
001000000000100
000000000000000
000000000000000
000000000000000
000000000000000
001000000000100
001100000001100
000000000000000
000000000000000