000000000000000
000000000000000
100000000000001
100110000011001
100100000001001
100000000000001
100000000000001
100100000001001
100110000011001
100000000000001
000000000000000
000000000000000